5 5
1 4 0 4 0
0 5 3 0 0
3 0 0 5 5
4 5 3 2 0
0 0 3 4 0
